###############################
      #           #           #
#  #  #######  #######  ####  #
#  #     #  #     #        #  #
#  #######  #  #######  #  #  #
#     #     #     #     #  #  #
####  #  #######  ####  #  ####
#     #           #     #     #
#  ##########  #######  #  #  #
#  #        #  #  #  #  #  #  #
#  ####  ####  #  #  #  #  ####
#        #     #        #     #
#  ##########  #  #  #  #######
#     #     #     #  #  #  #  #
#  ####  #######  ####  #  #  #
#                 #        #  #
##########  #######  #  #  #  #
#     #     #  #  #  #  #     #
#  ####  #  #  #  ####  #  ####
#        #  #           #     #
###############################