#####################
F   #     #     #   #
# ##### ### # ##### #
#     #   # #   #   #
### # ### ### ### ###
#   #     # #       #
# # ### # # ### # ###
# #   # #       # # #
# ### ### ### # ### #
#   # #   #   # #   #
# ####### ##### ### #
#     #   #         #
# ##### ##### # ### #
#     # #   # #   # #
# # ### ### ### #####
# #   # #     #   # #
##### ### ### # # # #
# #   # # #   # #   #
# ### # # # # # #####
#       # # #       #
#####################