#############################################################
F       #         #     #         #                 # o     #
##### ### ########### # # ####### # ### ### # ### # ####### #
#   #       #       # #   #         #   #   #   # # #   #   #
### # ### ### ### ### # ### # # # ### ########### ##### ### #
# #   # #   # #   #   # #   # # #   # #           #     #   #
# ##### # # ##### # # ### ##### ########### # # # # ####### #
# #   # # # #       #   #   #   #     #   # # # # #     #   #
# # ### ### ### # ##### # ### # # ####### ### ### # # # ### #
# #       #   # #     # #   # # # #       # #   #   # #     #
# ####### # ##### # ##### ### ### ####### # # # ### ####### #
#   #     #   #   # # #     #   #   #   #     #   # #   #   #
# ### ### # ######### # ##### ### # # # ####### ##### ##### #
#     # #           #   # # #   # #   #   #       #   #   # #
### ### # ### ####### ### # # ### ##### ######### ### # ### #
#   #   #   #     # # #   #   #   #           #   #       # #
### ### # # ### ### # # # # # ### # ### ####### ####### ### #
#   #     #   # # #     # # # #   # # # #   #     # #   o   #
# ### ##### ### # # ##### ### # ##### ### ####### # # ##### #
# o #   #   #         #     #       #             #   #     #
#############################################################