#############################################################
F #       #           #         #   #     # # #     #     # #
# # ##### ### ### ######### ####### ### # # # # ##### ##### #
# # #     # # #           # #   #       #     #             #
# ##### ### ##### # # ##### ### ####### ####### ### ##### ###
#   #     # #   # # # # #         #       #     #   # #   # #
# ### # # # ### ### # # # # ### ### ### ### ####### # # ### #
#     # #     #   # #   # #   # # # #     #     #   #       #
##### # ##### ### ### ######### # ####### ######### # ### # #
#     # #     #   # #     #         #       #     o #   # # #
############# # ### ### # # # ### # # ##################### #
#     #       #     #   #   #   # #       #   # #         # #
##### # # ### # ### ##################### ### # ####### ### #
#       #   # #   # #       #     #         #     # #   # # #
####### ### # # # ### # ### # ### # ######### # ### ### # # #
# # #   # # #   #     #   #     # #         # #   # # #     #
# # ##### ### # # ### ########### # # # ### ##### # # ### ###
#             # # #             # # # #   #       #       # #
### ### # ### ### # ### # ### # ### # ### # # ######### ### #
#   #   #   # #   # # # #   # #     # # # # #   #           #
# ####### # # ### ### ### # # # ### ### ### ### # ### ##### #
# #     # # #   # # #     # # #   # # #     #       # #     #
### # ########### # # ### # ##### # # # ### ##### # ####### #
#   # # #         # # # # # #   # # #   # #   # # # #       #
### # # # # # # # # ### ### ### ####### # # ### # ###########
#   #     # # # # #     #         # # # # #   #         # # #
######### ### # ##### # ### ##### # # # # # ##### # ### # # #
# #       #   #       #   #     # # # # #   #     #   #   # #
# # ##### ##### # ##### # # ### ### # # # # ##### ### # ### #
# o   #   #     #     # # #   #   #     # # #       # #  o  #
#############################################################